1111111111
1N00000001
1000000001
1000000001
1000010001
1000000001
1000000001
1000000001
1000000001
1111111111