NO texture/pipi.xpm feurnn


WE texture/caca.xpm

EA texture/caca.xpm kikiki

pipi

C            255,             84,         0

SO texture/pipi.xpm

F            154,             200,         74

1111111111111111111111111
1000000000110000000000011
1011000011100000000000011
1001000000000000000000W11
1111111111111111111111111