NO texture/test.xpm feurnn


WE texture/test.xpm

EA texture/test.xpm kikiki

pipi

C            255,             84,         255

SO texture/test.xpm

F            154,             200,         74

1111111111111111111111111111
1000000000110000000000011001
1011000011100000000000011001
1001000000000000000000W11001
1111111111111111111111111111