N           ./test.xpm feurne


W               test.xpm

E              test.xpm kikiki

pipi

C            10,             84,         0

S test.xpm

F            154,             200,         74

        1111111111111111111111111
        1000000000110000000000001
        1011000001110000000000001
        110000000000000000000011
11111111001100000111000000000001
100000000N11000001110111111111111
11110111111111011100000010001
11110111111111011101010010001
1100000011010101110000001000111
1111111111111111111111111111111
1111111111111111111111111111111
11111111111111111111111111111
10000000000000001100000010001
10000000000000001101010010001
1100000111010101111101111000111
11110111 1110101 101111010001
11111111 1111111 111111111111